{
  tileMap: {
  }
  entityMap: {
    W: object_wall_0
    T: chore_tv_0
    B: object_bookshelf_0
    L: object_sofa_large_0
    l: object_lamp_0
    E: chore_energy_drink_0
    N: object_nintendo_0
    C: object_sofa_large_0
    c: object_sofa_small_0
    Z: chore_plant_0,
    t: object_plant_0

  }
  tileGrid: [
    [., ., ., ., ., ., ., ., ., ., ., .],
    [., ., ., ., ., ., ., ., ., ., ., .],
    [., ., ., ., ., ., ., ., ., ., ., .],
    [., ., ., ., ., ., ., ., ., ., ., .],
    [., ., ., ., ., ., ., ., ., ., ., .],
    [., ., ., ., ., ., ., ., ., ., ., .],
    [., ., ., ., ., ., ., ., ., ., ., .],
    [., ., ., ., ., ., ., ., ., ., ., .],
    [., ., ., ., ., ., ., ., ., ., ., .]
  ]
  entityGrid: [
    [W, W, W, W, W, W, W, W, W, W, W, W],
    [W, ., ., ., l, ., T, ., ., ., ., .],
    [W, t, ., ., ., ., ., N, ., ., ., .],
    [W, t, ., ., L, ., ., ., ., ., ., .],
    [W, ., ., ., ., ., ., ., ., ., ., .],
    [W, ., ., ., Z, ., ., ., E, ., ., .],
    [W, ., ., ., ., ., ., ., ., ., ., .],
    [W, ., ., ., ., ., ., ., ., ., ., .],
    [W, ., ., ., ., ., ., ., ., ., ., .]
  ]
}