{
  tileMap: {
  }
  entityMap: {
    W: object_wall_0
    T: chore_tv_0
    B: object_bookshelf_0
    L: object_sofa_large_1
    l: object_lamp_0
    E: chore_energy_drink_0
    N: object_nintendo_0
    C: object_sofa_large_0
    c: object_sofa_small_0
    Z: chore_plant_0
  }
  tileGrid: [
    [., ., ., ., ., ., ., ., ., ., ., .],
    [., ., ., ., ., ., ., ., ., ., ., .],
    [., ., ., ., ., ., ., ., ., ., ., .],
    [., ., ., ., ., ., ., ., ., ., ., .],
    [., ., ., ., ., ., ., ., ., ., ., .],
    [., ., ., ., ., ., ., ., ., ., ., .],
    [., ., ., ., ., ., ., ., ., ., ., .],
    [., ., ., ., ., ., ., ., ., ., ., .],
    [., ., ., ., ., ., ., ., ., ., ., .]
  ]
  entityGrid: [
    [W, W, W, W, W, W, W, W, W, W, W, W],
    [W, B, ., ., ., ., T, ., ., ., ., .],
    [W, B, ., ., ., ., N, ., ., ., ., .],
    [W, ., ., E, ., ., ., ., ., Z, ., .],
    [W, ., ., ., ., ., ., ., ., ., ., .],
    [W, ., ., l, ., ., L, ., E, ., ., .],
    [W, ., ., ., ., ., ., ., ., ., ., .],
    [W, ., ., ., ., ., ., ., ., ., ., .],
    [W, ., ., ., ., ., ., ., ., ., ., .]
  ]
}