{
  tileMap: {
  }
  entityMap: {
    W: [object_wall_0, 0]
    T: [chore_tv_0, 0]
    B: [object_bookshelf_0, 0]
    L: [object_sofa_large_0, 0]
    u: [object_sofa_large_1, 0]
    l: [object_lamp_0, 0]
    E: [chore_energy_drink_0, 0]
    N: [object_nintendo_0, 0]
    C: [object_sofa_large_0, 0]
    c: [object_sofa_small_0, 0]
    Z: [chore_plant_0, 0]
    t: [object_plant_0, 0]
  }
  tileGrid: [
    [., ., ., ., ., ., ., ., ., ., ., ., .]
    [., ., ., ., ., ., ., ., ., ., ., ., .]
    [., ., ., ., ., ., ., ., ., ., ., ., .]
    [., ., ., ., ., ., ., ., ., ., ., ., .]
    [., ., ., ., ., ., ., ., ., ., ., ., .]
    [., ., ., ., ., ., ., ., ., ., ., ., .]
    [., ., ., ., ., ., ., ., ., ., ., ., .]
    [., ., ., ., ., ., ., ., ., ., ., ., .]
    [., ., ., ., ., ., ., ., ., ., ., ., .]
    [., ., ., ., ., ., ., ., ., ., ., ., .]
  ]
  entityGrid: [
    [W, W, W, W, W, W, W, W, W, W, W, W, W]
    [W, ., ., ., ., ., T, ., ., ., ., ., W]
    [W, t, ., ., ., ., ., N, ., ., ., ., W]
    [W, t, ., ., L, ., ., ., ., ., ., ., W]
    [W, Z, ., ., ., ., ., ., ., ., ., ., W]
    [W, Z, ., ., l, ., u, ., E, ., ., ., W]
    [W, ., ., ., ., ., ., ., ., ., ., ., W]
    [W, ., ., ., ., ., ., ., ., ., ., ., W]
    [W, ., ., ., ., ., ., ., ., ., ., ., W]
    [W, W, W, W, W, W, W, W, W, W, W, W, W]
  ]
}